111111111111111
10000000P00C0C1
101101111111111
1E01000000C0C11
101101111111111
101101111111111
101101111111111
101101111111111
101101111111111
111111111111111