11111111111111E
10010000P00C0C1