1111111111111111111111111111111111
1000000000000000000000000000000001
10P0000000000000000000000000000001
10000000000000F0000000000000000001
1000000000000000000000000000000001
1000000000000000000000000000000001
1000000000000000000000000000000001
1000000000000000000000000000000001
1000000000000000000000000000000001
1000000000000000000000000000000001
100000000000000000000000000000F001
1000000F00000000000000000000000001
1000000000000000000000000000000001
1000000000000000000000000000000001
1000000000000000000000000000000001
1000000000000000000000000000000001
1000000000000000000000000000001011
1000000000000000000000000000001E01
100000000000000000000000000000C011
100000000000000000000000F000000001
1000000000000000000000000000000001
1000000000000000000000000000000001
1000000000000000000000000000000001
1000000000000000000000000000000001
10000000000F0000000000000000000001
1000000000000000000000000000000001
1000000000000000000000000000000001
1000000000000000000000000000000001
1000000000000000000000000000000001
1000000000000000000000000000000001
1000000000000000000000000000000001
100000000000000000000000000F000001
1000000000000000000000000000000001
10000F0000000000000000000000000001
1000000000000000000000000000000001
1000000000000000000000000000000001
1111111111111111111111111111111111
