111111111111111
10010000P00C0C1
111111111111111
1001000000C0C11
111111111111111
100100E000C0C11
111111111111111
1001000000C0C11
11111111111111C
1001000000C0C11
111111111111111